20 20 1,180 20 3,280 20 1,20 220 2,120 220 3,120 320 1
20 20 1,120 120 3,220 220 4,290 220 2,380 220 3,120 300 1
20 20 4,120 20 4,320 20 3,20 120 4,220 120 4,520 120 4
20 20 2,220 20 1,450 20 4,20 220 2,120 220 3,320 320 3
20 20 4,200 120 3,220 220 4,320 120 3,120 220 3,120 120 1
